#?##################
#                  #
# ################ #
# #        #   #   #
# # #### #    #   ##
# # #    #######  ##
# # #    #         #
# # #    # ### #####
#   # ##           #
##################!# 