#?##################
#                  #
# ################ #
# #        #   #   #
# # #### #    #   ##
# # #    ######## ##
# # #    #         #
# # #    # #########
#   # ##           #
##################!#