#?##################
#                  #
# ################ #
# #        #   #   #
# # #### #    #   ##
#   #    ######## ##
###      #         #
###      # #########
# # ##             #
##################!#